#########################################################################
									#					
#################    ####################################################
									#	
###   #########################    ###############################  #####
                                         				#	
##############   ######################################################## 
									#			
#######################    ##############################################
									#
###########   ####################################################   ####
									#			
####   #################   ######################    ####################
									#
###########    ######################################################   #
									#
#####################   #################################################
