#########################################################################
#-----------------------------------------------------------------------#
#################----####################################################
#-----------------------------------------------------------------------#
###----#########################----############################----#####
#-----------------------------------------------------------------------#
##############----#######################################################
#-----------------------------------------------------------------------#
#######################----##############################################
#-----------------------------------------------------------------------#
###########----#################################################-----####
#-----------------------------------------------------------------------#
####----################----#####################----####################
#-----------------------------------------------------------------------#
###########----#####################################################----#
#-----------------------------------------------------------------------#
#####################|####|##############################################
