#########################################################################
------------------------------------------------------------------------#
#################----####################################################
------------------------------------------------------------------------#
###----#########################----############################----#####
------------------------------------------------------------------------#
##############----#######################################################
------------------------------------------------------------------------#
#######################----##############################################
------------------------------------------------------------------------#
###########----#################################################-----####
------------------------------------------------------------------------#
####----################----#####################----####################
------------------------------------------------------------------------#
###########----#####################################################----#
------------------------------------------------------------------------#
#####################|----|##############################################
